1111111111111111111111
10000000000000000000S1
100C000000000000000C01
100000000000000000V001
1P0000000000000000CE01
100000000000000000X001
1C00000000000000000C01
10000000000000000000A1
1111111111111111111111